spr: ybf nsx pik
apj: glk nxz anl adl
hml: tds jou hoq ntr
hyj: duf vov
gyc: eed fjr
gtb: hyn ozz
ytb: lyo kgx tyh
lje: rop tkv wuu uay
hyv: ogg aia crh epx
jec: zjs ifv
udu: fnx qlo
yyc: iyq vdj
uim: bde hcf oxg odr
doh: gus dpp vgi jvl
fwa: ozn
aza: lyt fvj jjs fdc
odv: out
tpa: aur
emv: naq ewb qic nbf
lne: sln you
pik: mcf hpu cev lak
ozn: moa jhu
sry: nii dbm
qoo: cla sce lxf
glk: vgi use
zbp: out
uow: you sln
wad: wji nos xsj
qjs: nhg osa doo
iva: dpw nbu hmi gid
uay: wip
ewb: saf klw
mib: gfc qjs ouv rlc
odr: pey ezh zcc wpu mim
fjl: nxa ciw
dby: zgq
wzs: jhu
akt: qej cet
ouv: doo
hmi: htv fgi fmr
zwc: lkl wgr dbx lmn anq vev kpy vqw efy hws fbh lbm xkq ybi
hxz: ufu tnf nii
rcd: fad
les: uzt aea
zwo: ytp aza
ysv: fft aew mzt jll wxb
lbm: pnx zrp eoc nyi svg
fft: boh auv
xcx: ybi lbm fbh efy vev kpy anq abf dbx dts wgr xba
akp: wyx rop
nxa: cet
rlc: nhg doo osa ytl
uoa: yub imj spf
esp: mij gtb odm
fll: puz tqa zdf bfz spr oiq nhe ion oli obb iwu pqf vue mib jmz mez egt lgt dkg jlq ggu ldo miu jcc
nbs: hdp mro
ivm: thj rsc
xph: zga esf lne
lak: mfa
eeb: azc
ojb: out
xjm: ryt rpc tjv
hez: rou hyv qwr
nhe: qjs
ozu: pdz les ssu
zdv: wvj
ozv: yem kcs mgs ari
vzt: yqx oat yie xvv wiy
cdv: ljv
oli: pik ugi
imj: xsy csr frj
lkl: smz dji kxr vwr
tqa: jkt zbo awc
eoc: jkg
bmy: rpc
dji: lwu pvx rpp
qxe: zjv elu
pey: ghu yin
xxm: klx itz vtp afg ydf eoq zat xsv wad sew oqk ier xsi dyf zpa
lmn: akp
gdn: out
cev: mfa fuz
ari: sln you
hub: pjs doh cfu
ciw: awz xxm
set: yzn
wji: yni vjo ivm
thv: xxm qej tfm
svd: ufu nii euu
bur: out
phq: ejf dlh
jcc: czv
ffk: out
gyp: vdj
spf: csr frj
nqp: dyj
vxe: yfq ufz
htl: kgx tyh akr lyo tgg
moa: awz tfm cet xxm
anq: htx lje akp
cip: stk lzw
stk: yfp flm
ssu: nqb
vev: lpa qfl
zqy: bfz obb vbs lgt puz jcc ion uoa spr
hws: eoc nyi
dai: sea jec gaz
hyn: pyo odv dyj
ljv: jib wlh osb cee
qfu: odm mij gtb
ewn: out
cfu: gus dpp use jvl vgi
dye: fll
hwv: ciw
gmm: wzn akt paz
yni: fad thj rsc
dbm: dkj ctd
ejv: mna xjm gdo hep
jjs: kqo
gaz: ojb
agh: cww
rsc: wif rcp zqj kub xty psg ogp qcn
csr: sln
uxe: xqu
qlo: fgs xqt krw
mfa: wgz fhj baw
egt: imj yub
pyo: out
zga: sln wts
zwe: gbt hdw nlk
xsi: nzr
ntr: vxe ruh itt
bof: fad rsc
wdy: ozz cvh
ywz: hks rmi
ozz: dyj pyo
zzj: qlo fnx zqb
xzx: qej xxm awz tfm
lof: zgv dai vhf pyl
ruh: ufz yfq
vkk: zqy fll
krw: qej tfm awz
ghj: jhu
ecj: tnf euu ufu
ybi: sry ecj hxz
wrb: ysv vlb boj
nbu: fgi fmr
epx: sfd vrq gmm
yrq: xsx emv
ekm: pxw fjl
pcn: xso vpq avq
pxw: fqd nxa xzx
ufu: edl dkj ctd
rop: yfv iwi
xzs: odr
qer: nbu ejw
fus: lsk tpa
mcf: chq mfa
jll: gdi
nqb: mro
zcc: reo ghu
jib: urb uum jgi
kxr: hub rpp
rxt: mfr vdj
xqu: bls lgy
ghu: zqy fll
jnp: out
zdf: nsx ybf pik
anc: obe udu xeo
jkg: fnz vzt
nos: ivm yni
pjs: gus dpp jvl vgi
sew: xqu
uzt: zdv gyc hdp
mee: lzw stk
cww: esp qmc gyt zzk
afg: xpf nlk
zkr: ntr ypg hoq
oat: jvl
rcp: odr bde oxg
auv: gqx fio ous
azz: set
utf: cla akw
odm: nqp cvh hyn gqq
doo: eeb anb xph
fbh: ecj sry svd fch hxz
jmz: yub dac spf
bpk: vlb boj imu
gbt: szg evv
ild: hoq ypg jou tds
nbf: eml saf rcd olu
ucs: aza rrz
yub: xsy csr
wkz: nww kjq
lzw: qir
amk: yow hmw mee
hmw: mca stk
rho: nhe oiq spr zdf bfz tqa agq puz vbs jcc miu ldo ggu jlq mez egt lgt jmz vue mib pqf uoa iwu obb
zjs: out
use: odx dxl bpk ews jqd onx vfe tqq jir
vhf: gaz
qic: eml saf rcd klw
psg: pcn wdm vyy ykk
jkt: gjv dfm sqh rid
arx: yxy
rrz: fdc jjs lyt
wuu: yfv
gjv: sln you
hdw: cwo szg ywg evv jla
gdo: vot
nii: edl
fuz: wgz fhj zhb
fch: euu tnf dbm
tit: xwn dbr otg
rod: mee cip yow
ogp: bfy zjv elu
qir: cpc oqt
dbr: hwv fzf
jqd: rmi iwv
kpy: eoc pnx zrp
wpa: zzj xeo
tfz: ljv suv div
cel: hml zkr
she: mca
rwj: wpa anc
uum: rxt
wcx: hrg
rdq: luk
vdj: out
hpu: chq
fvj: epp
xnt: buq htl dcv ytb
ufz: fll zqy rho
ews: wym anc
chq: fhj zhb
lvx: aza rrz ytp
rkm: iyq mfr
flm: kbf cpc oqt
thj: wif rcp xxd qcn xty kub phw psg zqj qxe bnm ruc olr wlr xzs uim
iwv: eht but
znn: ghj
osa: anb xph jiq
obb: ybf ugi
akr: bof ofh
ezh: yin ghu reo
jlq: spf imj dac
dpp: mjh bpk ews jir zme dvm
oqk: emv xsx
wiy: vgi use dpp
jaq: paz
ypg: vhp vxe
kqb: hrg
kiq: hmi nbu gid dpw
klw: rsc
vli: glk
wgr: svg
aur: zgv
kjo: vjo
ulf: tgx zbp yfg
ywg: fad
kgx: fju bof
rmi: but qrt wkz eht ahp
dyf: ytb dcv
iwu: jkt
lpv: zgq hbv cww hbi
fhj: wts you
jou: rdb vhp ruh itt
otg: fzf yto pxw
zrl: fwa iyt vnp znn
qee: vqw hws efy xba wgr dts ybi qkr kpy vev
gfw: awz tfm qej
szg: thj rsc
zhb: sln you
onx: otg ekm xwn
dqv: thj
azc: you sln
xsx: ewb naq nbf dtk
vwr: lwu pvx rpp
pvx: cfu pjs doh eql
lpa: dib set
ysq: dqv bls fbi
nhg: eeb anb
suv: jib cee osb wtb
xty: bfy
cwo: fad thj rsc
hoq: rdb itt vxe ruh
vue: czv ozv vbp
udr: ejf
xxd: utf osi pcg ivc
dac: xsy uow csr frj
ejr: out
mfr: out
fmr: wts sln
edl: vgi gus
ryt: ajd gbm
ivc: bne sce akw
vog: otg ekm dbr
eoq: gbt xpf
ogg: sfd jaq vrq
vbs: kiq iva
euu: dkj
duf: yie yqx oat
ryz: out
mjh: rou bhm hyv qwr lbs
zpa: ysq xqu nzr
tyh: fju
yxy: ffk bur ewn
val: moa gfw
pdz: uzt izd aea
nlk: ywg evv
hrg: lof aur eqm
vrq: wzn
zgv: sea hhl
eht: nww kjq
gdi: fio
lgy: rsc fad thj
mgs: you
fio: tfm awz cet qej
lyo: bof
cpy: you wts
oxg: zcc
zme: iwv hks
zzk: mij odm wdy
zyh: fwa iyt vnp
rdb: yfq nnk
kqo: pta
xsv: htl buq
rfd: krw vve
oqt: blk jnp ryz
jyp: ewn
ajt: anc
ejw: fgi fmr
ujs: zgq hbi hbv cww
zrp: jkg hyj mfl
fju: rsc thj
xwn: fjl fzf
aik: smz
tqq: wym
svg: hyj
wip: gus use dpp vgi
dfm: sln wts you
xvv: vgi jvl use dpp
nnk: rho zqy
xso: rho fll
akw: zqy
vot: ulf gbm ajd
ugi: mcf hpu lak
qkr: svd sry fch
jgy: pjs
yto: fqd
fnx: xqt
lsk: eqm
wgz: wts
mij: gqq
pnx: mfl hyj
vhp: yfq
dkj: dpp vgi jvl gus
lxf: rho zqy
crh: vrq
ldo: jkt
lbs: aia
tnf: edl ctd
wvj: fad thj rsc
ous: xxm tfm awz
tfm: rtg wad xnt ydf itz vtp dyf ier sew oqk xsv zat ozu eoq klx uxe afg zpa xsi bxw yrq usk ahh
ytl: xph anb eeb
gjo: fbh lbm vqw hws efy gwv ybi xkq lkl xba wgr aik lmn anq yur qkr kpy dbx
qcn: osi qoo ivc
smz: rpp jgy lwu
bhm: xvk crh epx ogg
dpw: fgi htv
xwc: rxt luk rkm gyp
lyt: arx epp kqo
yfg: out
jir: lbs qwr hyv bhm
qmc: wdy mij
cee: uum
hbv: qfu qmc
bls: rsc
yfq: zqy fll
wtb: xwc jgi
rou: xvk crh epx
jhu: awz xxm cet qej
ofh: rsc
ruc: utf osi ivc qoo
svr: zwc gjo qee xcx wbr
yfp: kbf cpc oqt
xba: kxr
jdi: slw
nhx: wdm ykk pcn
yow: mca
dts: pnx
itt: yfq nnk ufz
yqx: dpp vgi jvl gus
wym: zzj obe udu
aea: hdp gyc
wxb: boh
jeg: she yow cip
vjo: fad rsc
ggu: gfc
boh: gqx
dbx: smz
fgi: sln wts
bde: pey mim wpu zcc
zat: buq
olu: fad
ezp: wts
ion: qer iva
mca: yfp
tho: iwv hks rmi
saf: thj
buq: tyh lyo
nem: vli apj yzn
tkv: yfv iwi wip
zjv: vkk
adl: use jvl gus
mro: fjr wvj
olr: dia
pyl: sea jec hhl
lgt: zbo awc
qwr: aia epx xvk
qfl: dib nem
fjr: thj fad
ctd: vgi dpp use
uxx: ejv dlh
wlr: qoo pcg
jgi: yyc rxt rkm
tgx: out
snr: tfm qej
vmo: suv div
vsa: lsk
ajd: ejr tgx gdn
czv: yem ezp kcs
xpf: evv jla
mim: ghu
gid: fgi
vfe: ysv imu boj
vpq: rho
nww: cet qej xxm awz tfm
cet: ydf eoq xnt vtp afg uxe klx itz wad zat rtg xsv bxw ier ahh zpa xsi
ifv: out
yzn: nxz yhm
cjp: hoq ypg jou tds ntr
rtg: jlv emv xsx
vve: awz tfm qej cet
xkq: akp htx
fdc: epp arx
imu: aew fft
fad: wif xxd rcp qcn cel xty kub psg zqj qxe ogp bnm ruc wlr xzs nhx
eql: vgi
mfl: vov vzt
dlh: hep bmy gdo
fgs: cet qej
lwu: pjs eql cfu
vlb: mzt aew
naq: rcd
jvl: bct zyh zme rwj tit mjh jir hez dvm bpk odx ywz
izd: mro
nxz: jvl vgi dpp use gus
wlh: jgi
dtk: olu rcd saf eml
evv: fad thj rsc
yie: dpp
wpu: ghu
okr: uzt nbs
cvh: pyo
bzn: ejv dlh
dyj: out
boj: jll wxb aew fft mzt
mez: ugi ybf pik nsx
jla: thj
ykk: avq yrm
awz: zwe usk ozu yrq uxe zpa sew wad rtg
zgq: zzk qfu esp
gqx: cet qej awz
obe: zqb dho rfd qlo
mzt: auv
klx: ytb
xqt: awz cet qej xxm
wbr: lkl fbh aik anq gwv lmn abf dbx xkq
bct: bhm hyv lbs
brw: glk adl
eed: rsc
rpp: eql
nyi: mfl jkg
osi: akw sce lxf
xsy: sln you
tds: itt vxe ruh vhp
iyt: ozn wzs val
efy: akp htx
kub: hml cjp dia ild
bne: fll
yrm: fll rho zqy
mna: tjv
kjq: qej xxm awz tfm
hbi: gyt qfu
wzn: awz tfm cet xxm
sqh: wts you sln
gwv: azz qfl
ahh: jlv
bnm: oxg
but: snr nww kjq
nsx: cev
agq: rlc
gus: wrb rwj vog tho zyh ywz odx dvm tqq hez onx ajt mjh tit vfe zme bct jqd zrl ews bpk jir
yhm: vgi jvl
mne: ulf ajd
gvd: tfm xxm cet qej
ytp: lyt fvj fdc jjs
anl: gus
sln: uxx fbu bzn jeg dby evb ucs agh ujs kqb wcx vsa aud siy phq fus amk tfz lvx cdv lpv zwo loq
sfd: paz
ybf: mcf cev hpu
urb: luk rkm yyc gyp
gfc: ytl osa doo
dkg: ozv czv
iyq: out
dcv: tgg
gqq: dyj
evb: suv ljv
aew: auv boh
gbm: gdn tgx zbp yfg
frj: you wts
vnp: wzs val ghj
xeo: zqb rfd
wts: udr ucs vmo tfz evb amk vsa wcx lpv kqb loq rod agh lvx ujs cdv siy bzn aud dby jeg phq fus
aia: jaq gmm
sea: zjs ifv ojb
fzf: ciw nxa xzx
rid: sln
awc: sqh
pyv: out
iwi: dpp vgi jvl gus
ahp: gvd
luk: mfr
dho: vve fgs xqt
you: tfz fbu cdv agh uxx ucs rod vmo
pqf: czv ozv
ier: xqu ysq
jiq: lne esf zga
sce: zqy rho fll
yur: lpa azz hvl
kcs: wts sln
avq: zqy
tgg: ofh
vtp: okr ssu
odx: iyt znn
wyj: tfm xxm
paz: tfm awz
bfz: czv ozv
baw: wts
hhl: ojb ifv
bxw: wji kjo xsj jdi
rpc: gbm ajd ulf
fbu: cip hmw mee yow
slw: rsc fad
vgi: bct tho wrb rwj zrl
epp: jyp yxy
xsj: ivm vjo
esf: you
blk: out
zqj: hcf
hcf: zcc mim pey ezh
nzr: bls dqv
vyy: avq vpq
wdm: avq xso yrm
dia: jou tds hoq
wyx: yfv iwi
wif: ild dia cjp hml zkr
aud: she
usk: okr pdz les
hks: but ahp eht
abf: vwr
qrt: thv
kbf: pyv ryz blk
osb: urb rdq
dib: yzn vli brw
ydf: jdi nos kjo
yfv: jvl dpp use
vov: yie wiy yqx oat
yin: zqy rho
vbp: ari
vqw: fch hxz
fqd: xxm tfm
hep: ryt tjv mne
eqm: pyl vhf
htx: wuu
gyt: gtb mij odm
jlv: nbf qic dtk ewb
oiq: iva
dci: fll rho
dxl: rou hyv bhm qwr lbs
pta: ewn bur ffk
siy: dlh
hvl: dib
puz: imj dac
ejf: mna gdo xjm
fnz: yqx xvv yie wiy
htv: sln you
eml: rsc thj fad
xvk: jaq sfd vrq
phw: ykk pcn
loq: tpa lsk
anb: cpy
zqb: wyj vve krw
tjv: gbm
hdp: wvj fjr
qej: ahh bxw usk dyf zpa afg vtp xnt ozu eoq ydf rtg xsv zat oqk sew
itz: nos jdi
zbo: dfm gjv
cpc: pyv blk jnp
div: wlh osb
bfy: dci vkk
yem: sln wts
pcg: cla sce bne
miu: kiq iva qer
elu: dye dci
fbi: fad rsc
reo: rho
dvm: ysv imu
cla: rho